2 13 31
###############################
#  * *2       *  *b * f      *#
# # # # #*# # #*# # # # # #*# #
#    k * *s* *f    1  *    ** #
# #*# # # # #1# #b#3# # # # #*#
#          *     **      *  **#
# # #*# # # # # #*#*#*#*# # # #
#   *    k    *   * *x* *     #
# # # # #*# # # # # # #*# #*# #
#   *bs*     1    *2          #
# # # # # # # # # #*# # # # #*#
#  *s *   *    3              #
###############################