3 13 31
###############################
#    *b s*    *   2      3    #
# # # #*# # # # # # # # # # # #
#*     *f * b  *   * k* 3 *   #
# # # # # #*# # # # # # #*# # #
#*   *s*    *f* * x **        #
# # # # # # # # # # # # # #*# #
#    *     k   3     *    *b  #
# #*# # #*#*#*#*# # #1# # #*# #
#        *   *2*    *   f     #
#*# # # # # # # # # # #*# # #*#
# *    b **    *s **f     4   #
###############################